0 0 0 0 0 0 0 0 0 0 0 0 0 0 0 0 0 0 0 0 0 0 0 0 0 0 0 0 0 0 
0 0 0 0 0 0 0 0 0 0 0 0 0 0 0 0 0 0 0 0 0 0 0 0 0 0 0 0 0 0 
0 0 0 0 0 0 0 0 0 0 0 0 0 0 0 0 0 0 0 0 0 0 0 0 0 0 0 0 0 0 
0 0 0 1 1 1 1 1 1 1 0 0 1 1 1 1 1 0 0 1 1 1 1 1 1 1 1 0 0 0 
0 0 0 1 0 0 0 0 0 0 0 0 0 0 0 0 0 0 0 0 0 0 0 0 0 0 1 0 0 0 
0 0 0 1 0 0 0 0 0 0 0 0 0 4 0 0 5 0 0 0 4 0 0 0 4 0 1 0 0 0 
0 0 0 1 0 0 4 0 0 0 0 0 0 0 0 0 0 0 0 0 0 0 0 0 0 0 1 0 0 0 
0 0 0 1 0 0 0 0 0 0 0 4 0 5 0 0 0 4 0 0 0 4 0 4 0 0 1 0 0 0 
0 0 0 1 4 0 0 0 3 0 4 0 0 0 0 0 4 0 0 0 0 0 0 0 0 0 1 0 0 0 
0 0 0 1 200 0 0 0 0 0 0 4 0 0 0 0 0 4 0 0 4 0 4 0 4 0 1 0 0 0 
0 0 0 1 0 0 4 0 4 0 4 0 0 0 0 5 4 0 0 0 0 0 4 0 0 0 1 0 0 0 
0 0 0 1 0 0 0 0 0 0 0 0 0 0 0 0 0 4 0 0 0 0 0 5 0 0 1 0 0 0 
0 0 0 1 4 0 0 0 5 0 0 4 0 100 0 0 0 0 0 0 5 4 0 220 0 0 1 0 0 0 
0 0 0 1 0 0 4 0 0 0 0 0 4 0 0 0 4 0 0 0 0 0 0 0 0 0 1 0 0 0 
0 0 0 1 0 0 0 0 4 0 0 4 0 230 0 0 4 0 4 0 0 5 0 4 0 0 1 0 0 0 
0 0 0 1 0 0 4 0 0 0 0 0 4 0 0 4 4 0 0 0 0 0 0 0 0 0 1 0 0 0 
0 0 0 1 0 0 0 0 0 0 0 4 0 0 0 0 0 0 0 4 0 4 0 4 0 0 1 0 0 0 
0 0 0 1 4 0 0 0 0 0 0 0 4 0 4 0 4 0 0 0 0 0 4 0 0 0 1 0 0 0 
0 0 0 1 0 0 0 0 0 0 0 5 0 0 0 5 0 0 0 0 0 0 0 0 0 0 1 0 0 0 
0 0 0 1 0 4 0 0 4 0 0 0 0 0 0 0 0 0 0 0 5 0 0 0 4 0 1 0 0 0 
0 0 0 1 0 0 4 0 0 0 4 0 5 0 5 0 4 0 0 0 4 0 0 0 0 0 1 0 0 0 
0 0 0 1 0 0 0 0 0 0 0 4 0 0 0 0 0 4 0 0 0 0 0 4 0 0 1 0 0 0 
0 0 0 1 0 0 0 0 0 0 4 0 0 0 0 0 4 0 0 0 0 0 0 0 0 0 1 0 0 0 
0 0 0 1 0 4 0 210 0 0 0 4 0 0 0 0 0 4 0 0 0 5 0 0 0 0 1 0 0 0 
0 0 0 1 0 0 0 0 0 0 0 0 0 0 0 0 0 0 0 0 0 0 0 4 0 0 1 0 0 0 
0 0 0 1 0 0 0 0 0 0 0 0 0 0 4 0 0 0 0 0 0 0 0 0 0 0 1 0 0 0
0 0 0 1 1 1 1 1 1 0 0 1 1 1 1 1 1 0 0 1 1 1 1 1 1 1 1 0 0 0 
0 0 0 0 0 0 0 0 0 0 0 0 0 0 0 0 0 0 0 0 0 0 0 0 0 0 0 0 0 0 
0 0 0 0 0 0 0 0 0 0 0 0 0 0 0 0 0 0 0 0 0 0 0 0 0 0 0 0 0 0 
0 0 0 0 0 0 0 0 0 0 0 0 0 0 0 0 0 0 0 0 0 0 0 0 0 0 0 0 0 110 
